# -- welcome --
welcomeHeading=مرحبا
signup=تسجيل جديد
username=اسم المستخدم
birthDate=تاريخ الميلاد
name=الاسم
password=كلمة المرور
position=الوظيفة
confirm_password=تأكيد كلمة المرور
phone_no=رقم الهاتف
login=دخول
sign_out=خروج
sign_up_now=سجل دخول الان!
users=مستخدمين
not_a_user_signup=ليس لديك حساب
edit=تعديل
cancel=يلغي
save=حفظ
delete=مسح
edit_profile=تعديل الصفحة
add=اضافة
address=العنوان
mail=البريد الالكتروني
newTransaction=نقل جديد
reciever= رقم حساب المستقبل
sender= رقم حساب الراسل
amount=المبلغ
description=الوصف
totalnumberofclients=عدد العملاء
bestClient=افضل عميل
totalnumberofTransactions =عدد التبادلات
totalnumberofPendingTransactions=عددالتبادلات المعلقة
totalNumberOfTransactionsSubmitedByCurrentEmployee= التبادلات المنتهية بواسطتك
myPerformance= معدل الاداء
transactionDate= تاريخ التبادل
approve=موافق
reject=رفض
accountNumber=رقم الحساب
balance=الرصيد
availableBalance=الرصيد المتاح
salary=المرتب
transactions= التبدلات
updateSalary=تعديل المرتب
status= الحالة
editStatus= تعديل الحالة
transactionStatus= حالة التبادل
youhaveAnAccount= هل لديك حساب ؟
login_now= ادخل الان!
client=عميل
employee=موظف
extractReport = استخراج تقرير